XXXX..XXXXXXXXXXX
X.........X.X.X.X
X.>......X.X.h.XX
X.............X.X
X........s...X.XX
X...............X
XX.X.X.X.....X.XX
X.............X.X
XX.X.X.X........X
...@.......s....X
XX.XX.XXX..b....X
X..XX.XXX.bbX...X
XX...XX.XXX....XX
X.......XXX...X.X
XXX..XXXXXXXXXXXX
