XXXX..XXXXXXXXXXXXXXXX
X....................X
X....................X
X....................X
X....................X
X....................X
X....................X
X....................X
X....................X
.....................X
X....................X
X....................X
X....................X
X....................X
XXX..XXXXXXXXXXXXXXXXX
